1111111111
1000100001
1020106001
1000100601
1000100001
1000100001
1000000001
1060000001
1000000001
1000000601
1000000001
1111101111
1000000001
1001111001
1000000001
1000660001
1000000001
1111111001
1000000001
1060000001
1001111111
1000000001
1000000001
1000000001
1611111001
1000000001
1000000001
1111101111
1000000001
1001111001
1000000001
1000660001
1000000001
1111111001
1000000001
1060000001
1001111111
1000000001
1000000001
1000000001
1611111001
1000000001
1000000001
1111101111
1000000001
1001111001
1000000001
1000660001
1000000001
1111111001
1000000001
1060000001
1001111111
1000000001
1000000001
1000000001
1611111001
1000000001
1000000001
1111101111
1000000001
1001111001
1000000001
1000660001
1000000001
1111111001
1000000001
1060000001
1001111111
1000000001
1000000001
1000000001
1611111001
1000000001
1000000001
1111111111