111111111111111
100000000000000
100000000000200
100000000000000
100011111111111
100011000000001
100000000000001
111110011111111
100000000000001
100000000000001
111111111110001
100000000000001
100000000000001
111111001111111
100000000000001
110000000000001
101000000000001
100100000000001
106010000000001
100601000000001
100060100000001
100006010000001
100000601000001
100000060100001
100000006010001
100000000601001
100000000060001
100000000000001
100000000000001
111111111111111